{
    "Name": "Map 1",
    "Floor": {
        "DEFAULT_FRICTION": 0.3,
        "TILE_SIZE": 8,
        "ROWS": 100,
        "COLUMNS": 11,
        "CSV": [
            "1- ,1- ,1- ,1- ,1- ,1- ,1- ,1- ,1- ,1- ,1- ",
            "1- ,1- ,1- ,1- ,1- ,S- ,1- ,1- ,1- ,1- ,1- ",
            "1- ,1- ,1- ,1- ,1- ,1- ,1- ,1- ,1- ,1- ,1- ",
            "1- ,1- ,1- ,1- ,1- ,1- ,1- ,1- ,1- ,1- ,1- ",
            "1- ,1- ,1- ,1- ,1- ,1- ,1- ,1- ,1- ,1- ,1- ",
            "1- ,1- ,1- ,1- ,1- ,1- ,1- ,1- ,1- ,1- ,1- ",
            "1- ,1- ,1- ,1- ,1- ,1- ,1- ,1- ,1- ,1- ,1- ",
            "1- ,1- ,1- ,1- ,1- ,1- ,1- ,1- ,1- ,1- ,1- ",
            "1- ,1- ,1- ,1- ,1- ,1- ,1- ,1- ,1- ,1- ,1- ",
            "1- ,1- ,1- ,1- ,1- ,1- ,1- ,1- ,1- ,1- ,1- ",
            "1- ,1- ,1- ,1- ,1- ,1- ,1- ,1- ,1- ,1- ,1- ",
            "1- ,1- ,1- ,1- ,1- ,1- ,1- ,1- ,1- ,1- ,1- ",
            "1- ,1- ,1- ,1- ,1- ,1- ,1- ,1- ,1- ,1- ,1- ",
            "1- ,1- ,1- ,1- ,1- ,1- ,1- ,1- ,1- ,1- ,1- ",
            "1- ,1- ,1- ,1- ,1- ,1- ,1- ,1- ,1- ,1- ,1- ",
            "1- ,1- ,1- ,1- ,1- ,1- ,1- ,1- ,1- ,1- ,1- ",
            "1- ,1- ,1- ,1- ,1- ,1- ,1- ,1- ,1- ,1- ,1- ",
            "1- ,1- ,1- ,1- ,1- ,1- ,1- ,1- ,1- ,1- ,1- ",
            "1- ,1- ,1- ,1- ,1- ,1- ,1- ,1- ,1- ,1- ,1- ",
            "1- ,1- ,1- ,1- ,1- ,1- ,1- ,1- ,1- ,1- ,1- ",
            "1- ,1- ,1- ,1- ,1- ,1- ,1- ,1- ,1- ,1- ,1- ",
            "0- ,1- ,1- ,1- ,1- ,1- ,1- ,1- ,1- ,1- ,0- ",
            "0- ,0- ,1- ,1- ,1- ,1- ,1- ,1- ,1- ,0- ,0- ",
            "0- ,0- ,0- ,1- ,1- ,1- ,1- ,1- ,0- ,0- ,0- ",
            "0- ,0- ,0- ,0- ,1- ,C- ,1- ,0- ,0- ,0- ,0- ",
            "0- ,0- ,0- ,1- ,1- ,1- ,1- ,1- ,0- ,0- ,0- ",
            "0- ,0- ,1- ,1- ,1- ,1- ,1- ,1- ,1- ,0- ,0- ",
            "0- ,1- ,1- ,1- ,1- ,1- ,1- ,1- ,1- ,1- ,0- ",
            "1- ,1- ,1- ,1- ,1- ,0- ,1- ,1- ,1- ,1- ,1- ",
            "1- ,1- ,1- ,1- ,0- ,0- ,0- ,1- ,1- ,1- ,1- ",
            "1- ,1- ,1- ,0- ,0- ,0- ,0- ,0- ,1- ,1- ,1- ",
            "1- ,1- ,1- ,0- ,0- ,0- ,0- ,0- ,1- ,1- ,1- ",
            "1- ,1- ,1- ,0- ,0- ,0- ,0- ,0- ,1- ,1- ,1- ",
            "1- ,1-0,1- ,0- ,0- ,0- ,0- ,0- ,1- ,1-0,1- ",
            "1- ,1-0,1- ,0- ,0- ,0- ,0- ,0- ,1- ,1-0,1- ",
            "1- ,1-0,1- ,0- ,0- ,0- ,0- ,0- ,1- ,1-0,1- ",
            "1- ,1-0,1- ,0- ,0- ,0- ,0- ,0- ,1- ,1-0,1- ",
            "1- ,1-0,1- ,0- ,0- ,0- ,0- ,0- ,1- ,1-0,1- ",
            "1- ,1-0,1- ,0- ,0- ,0- ,0- ,0- ,1- ,1-0,1- ",
            "1- ,1-0,1- ,0- ,0- ,0- ,0- ,0- ,1- ,1-0,1- ",
            "1- ,1-0,1- ,0- ,0- ,0- ,0- ,0- ,1- ,1-0,1- ",
            "1- ,1- ,1- ,0- ,0- ,0- ,0- ,0- ,1- ,1- ,1- ",
            "1- ,1- ,1- ,0- ,0- ,0- ,0- ,0- ,1- ,1- ,1- ",
            "1- ,1- ,1- ,0- ,0- ,0- ,0- ,0- ,1- ,1- ,1- ",
            "1- ,1- ,1- ,1- ,0- ,0- ,0- ,1- ,1- ,1- ,1- ",
            "1- ,1- ,1- ,1- ,1- ,0- ,1- ,1- ,1- ,1- ,1- ",
            "1- ,1- ,1- ,1- ,1- ,1- ,1- ,1- ,1- ,1- ,1- ",
            "0- ,1- ,1- ,1- ,1- ,1- ,1- ,1- ,1- ,1- ,0- ",
            "0- ,0- ,1- ,1- ,1- ,1- ,1- ,1- ,1- ,0- ,0- ",
            "0- ,0- ,0- ,1- ,1- ,C- ,1- ,1- ,0- ,0- ,0- ",
            "0- ,0- ,0- ,1- ,1- ,1- ,1- ,0- ,0- ,0- ,0- ",
            "0- ,0- ,1- ,1- ,1- ,1- ,0- ,0- ,0- ,0- ,0- ",
            "0- ,0- ,1- ,1- ,1- ,1- ,0- ,0- ,0- ,0- ,0- ",
            "0- ,1- ,1- ,1- ,1- ,0- ,0- ,0- ,0- ,0- ,0- ",
            "0- ,1- ,1- ,1- ,1- ,0- ,0- ,0- ,0- ,0- ,0- ",
            "1- ,1- ,1- ,1- ,0- ,0- ,0- ,0- ,0- ,0- ,0- ",
            "1- ,1- ,1- ,1- ,0- ,0- ,0- ,0- ,0- ,0- ,0- ",
            "1- ,1- ,1- ,0- ,0- ,0- ,0- ,0- ,0- ,0- ,0- ",
            "1-0,1-0,1-0,0- ,0- ,0- ,0- ,0- ,0- ,0- ,0- ",
            "1-0,1-0,1-0,0- ,0- ,0- ,0- ,0- ,0- ,0- ,0- ",
            "1-0,1-0,1-0,0- ,0- ,0- ,0- ,0- ,0- ,0- ,0- ",
            "1-0,1-0,1-0,0- ,0- ,0- ,0- ,0- ,0- ,0- ,0- ",
            "1- ,1- ,1- ,1- ,0- ,0- ,0- ,0- ,0- ,0- ,0- ",
            "1- ,1- ,1- ,1- ,1- ,0- ,0- ,0- ,0- ,0- ,0- ",
            "0- ,1- ,1- ,1- ,1- ,1- ,0- ,0- ,0- ,0- ,0- ",
            "0- ,0- ,1- ,1- ,1- ,1- ,1- ,0- ,0- ,0- ,0- ",
            "0- ,0- ,0- ,1- ,1- ,1- ,1- ,1- ,0- ,0- ,0- ",
            "0- ,0- ,0- ,1- ,1- ,1- ,1- ,1- ,1- ,0- ,0- ",
            "0- ,0- ,0- ,0- ,1- ,1- ,1- ,1- ,1- ,1- ,1- ",
            "0- ,0- ,0- ,0- ,0- ,1- ,1- ,1- ,1- ,1- ,1- ",
            "0- ,0- ,0- ,0- ,0- ,0- ,1- ,1- ,1- ,1- ,1- ",
            "0- ,0- ,0- ,0- ,0- ,0- ,0- ,1-0,1-0,1-0,1-0",
            "0- ,0- ,0- ,0- ,0- ,0- ,0- ,0- ,1-0,1-0,1-0",
            "0- ,0- ,0- ,0- ,0- ,0- ,0- ,0- ,1-0,1-0,1-0",
            "0- ,0- ,0- ,0- ,0- ,0- ,0- ,1-0,1-0,1-0,1-0",
            "0- ,0- ,0- ,0- ,0- ,0- ,1- ,1- ,1- ,1- ,1- ",
            "0- ,0- ,0- ,0- ,0- ,1- ,1- ,1- ,1- ,1- ,0- ",
            "0- ,0- ,0- ,0- ,1- ,1- ,1- ,1- ,1- ,0- ,0- ",
            "0- ,0- ,0- ,1- ,1- ,C- ,1- ,1- ,0- ,0- ,0- ",
            "0- ,0- ,0- ,1- ,1- ,1- ,1- ,1- ,1- ,0- ,0- ",
            "0- ,0- ,0- ,0- ,1- ,1- ,1- ,1- ,1- ,1- ,0- ",
            "0- ,0- ,0- ,0- ,0- ,0- ,1- ,1- ,1- ,1- ,1- ",
            "0- ,0- ,0- ,0- ,0- ,0- ,0- ,0- ,1- ,1- ,1- ",
            "0- ,0- ,1- ,1- ,1- ,0- ,0- ,0- ,1- ,1- ,1- ",
            "0- ,1- ,1- ,1- ,1- ,1- ,0- ,0- ,1- ,1- ,1- ",
            "1- ,1- ,1- ,1- ,1- ,1- ,1- ,0- ,1- ,1- ,1- ",
            "1- ,1- ,1- ,0- ,1- ,1- ,1- ,0- ,1- ,1- ,1- ",
            "1- ,1- ,1- ,0- ,1- ,1- ,1- ,0- ,1- ,1- ,1- ",
            "1- ,1- ,1- ,0- ,1- ,1- ,1- ,0- ,1- ,1- ,1- ",
            "1- ,1- ,1- ,0- ,1- ,1- ,1- ,0- ,1- ,1- ,1- ",
            "1- ,1- ,1- ,0- ,1- ,1- ,1- ,0- ,1- ,1- ,1- ",
            "1- ,1- ,1- ,0- ,1- ,1- ,1- ,0- ,1- ,1- ,1- ",
            "1- ,1- ,1- ,0- ,1- ,1- ,1- ,0- ,1- ,1- ,1- ",
            "1- ,1- ,1- ,0- ,1- ,1- ,1- ,0- ,1- ,1- ,1- ",
            "1- ,1- ,1- ,0- ,1- ,1- ,1- ,0- ,1- ,1- ,1- ",
            "1- ,1- ,1- ,0- ,1- ,1- ,1- ,0- ,1- ,1- ,1- ",
            "1- ,1- ,1- ,0- ,1- ,1- ,1- ,0- ,1- ,1- ,1- ",
            "1- ,1- ,1- ,0- ,1- ,1- ,1- ,0- ,1- ,1- ,1- ",
            "1- ,1- ,1- ,0- ,1- ,F- ,1- ,0- ,1- ,1- ,1- ",
            "1- ,1- ,1- ,0- ,0- ,1- ,0- ,0- ,1- ,1- ,1- ",
            "1- ,1- ,1- ,1- ,0- ,0- ,0- ,1- ,1- ,1- ,1- ",
            "1- ,1- ,1- ,1- ,1- ,1- ,1- ,1- ,1- ,1- ,1- ",
            "0- ,1- ,1- ,1- ,1- ,1- ,1- ,1- ,1- ,1- ,0- ",
            "0- ,0- ,1- ,1- ,1- ,1- ,1- ,1- ,1- ,0- ,0- "
        ]
    }
}